111111111111111111
10P0000110C0000111
10C00000000C000011
100000011111111111
111110000000011101
1000000110C0000111
10C00001110C00E011
111111111111111111